έρχομαι -- I come
έχω -- I have, keep
αγαπώ / αγαπάω -- I love
αγοράζεται -- It is bought
αγοράζω -- I buy
αδυνατίζω -- I lose weight, become slimmer, weaken
ακούω -- I hear, listen (to), obey
αλλάζω -- I change, alter
ανάβω -- I light [fire, lamp, etc], provoke, turn on [light, etc]
ανατέλλει -- It rises [sun, etc], appears
ανεβαίνω -- I come / go up, climb, ascend
ανεβοκατεβαίνω -- I come / go up and down
ανησυχώ -- I worry
ανοίγω -- I open, turn on [something], begin, cut (open)
αξίζω -- I am (of) worth, deserve
απαγορεύεται -- It is forbidden, prohibited
απαντώ / απαντάω -- I answer, reply
απλώνω -- I spread / stretch (out)
αποφασίζεται -- It is decided
αποφασίζω -- I decide (on), make up my mind
αρέσω -- I please, give pleasure, am liked
αργώ -- I am late, lose time
αρπάζω -- I catch, snatch
αρχίζω -- I begin, start
αυξάνομαι -- I am increased
αυξάνω -- I increase
αφήνω -- I let, allow, leave [something]
βάζω -- I put (on), apply,
βάλλω -- I fire, shoot, hurl
βάφω / βάπτω -- I paint [not pictures], dye, polish
βγάζω -- I take off / out, remove, extract
βγαίνω -- I come / go out
βιάζομαι -- I hurry
βλέπω -- I see
βοηθώ / βοηθάω -- I help, assist
βρέχει -- It rains
βρίσκω -- I find, obtain
γίνομαι -- I become, happen, am done, produce
γελώ / γελάω -- I laugh
γεμίζεται -- It is filled, stuffed
γεμίζω -- I fill, stuff
γεννώ / γεννάω -- I bear, give birth (to), lay (eggs)
γιορτάζεται / εορτάζεται -- It is celebrated
γιορτάζω / εορτάζω -- I celebrate
γλιστρώ / γλιστράω -- I slip, slide, glide
γνωρίζω -- I know [someone], recognize, am acquainted with
γράφεται -- It is written, recorded
γράφω -- I write, record
γυρίζω -- I return, turn (around / back)
δέχομαι -- I receive, accept
δίνω -- I give, offer [price], yield
δανείζομαι -- I borrow
δανείζω -- I lend
δείχνω -- I show, indicate, point (at)
δημοσιεύεται -- It is published
δημοσιεύω -- I publish
διαβάζω -- I read
διαφημίζομαι -- I am advertised, made known
διαφημίζω -- I advertise, make known
διδάσκω -- I teach
διευθύνεται -- It is directed, managed
διευθύνω -- I direct, manage
διορθώνεται -- It is mended, corrected, punished
διορθώνω -- I mend, put right / straight, correct, punish
διψώ / διψάω -- I am thirsty
δοκιμάζω -- I try (on / out), test, taste, sample
δουλεύω -- I work (for), serve
δυναμώνω -- I strengthen, gain strength
δύει -- It sets [sun, etc], fades, declines
είμαι -- I am
εισάγω -- I import, put / bring in
ελκύω -- I attract, charm
ελπίζω -- I hope (for), expect
ενδιαφέρομαι -- I am interested
ενοικιάζεται -- It is rented, hired, for rent [to let]
ενοικιάζω / νοικιάζω -- I rent, hire, let
εξάγω -- I export, take / bring out
εξαρτάται -- It depends
εξηγώ -- I explain, interpret
επιδιορθώνω -- I repair
επισκέπτομαι -- I visit
επιτρέπεται -- It is allowed, permitted
εργάζομαι -- I work, function
ετοιμάζομαι -- I get [myself] ready, am prepared
ετοιμάζω -- I make ready / prepare [something]
ευχαριστώ -- I thank
εύχομαι -- I wish
ζηλεύω -- I envy, am jealous (of)
ζητώ / ζητάω -- I look / ask for, seek
ζω -- I live, experience
θέλω -- I want, need, require
θυμάμαι / θυμούμαι -- I remember, recall
θυμώνω -- I make / get angry
κάθομαι -- I sit (down), settle, remain
κάνω -- I do, make, perform
καθαρίζεται -- It is cleaned, cleared
καθαρίζω -- I clean, clear
καλώ -- I call, summon
καπνίζω -- I smoke
καταλαβαίνω -- I understand
κατασκευάζω -- I manufacture, make, construct
κατεβαίνω -- I come / go down, descend, dismount
κλαίω / κλαίγω -- I cry, weep, pity
κλείνω -- I shut, close, block / stop (up), conclude, turn off [something]
κοιμάμαι /κοιμούμαι -- I sleep
κοιτάζω / κοιτώ -- I look (at), take notice of, examine
κολυμπώ / κολυμπάω -- I swim
κοστίζει -- It costs
κουβεντιάζω -- I chat, discuss
κρατώ / κρατάω -- I hold, keep, withhold, detain, reserve, book, rule, prevail
κρυολογώ -- I catch a cold
κρυώνω -- I make / get / feel cold
κρύβομαι -- I hide [myself], am hiding
κρύβω / κρύπτω / κρύφω -- I hide / put away [something]
κόβω -- I cut (up / out), carve, grind
λέγεται -- It is said, told, named
λέω / λέγω -- I say, tell, name
λείπω -- I am absent, away, missing, lacking
λυπάμαι / λυπούμαι -- I regret, am sorry (for)
μένω -- I live, stay, remain
μαγειρεύω -- I cook
μαζεύομαι -- I am gathered, collected, get myself together
μαζεύω -- I gather, collect
μαθαίνω -- I learn, become aware, teach
μαλώνω -- I quarrel
μεγαλώνω -- I grow up / in size, enlarge
μελετώ / μελετάω -- I study [book / lesson]
μεταφράζω -- I translate
μετράω / μετρώ -- I count, measure
μιλώ / μιλάω -- I speak, talk
μοιράζω -- I divide, share (out), distribute
μου αρέσει -- I like (it), [Lit: it pleases me]
μου φαίνεται -- It appears / seems (to me)
μπαίνω -- I come / go in, enter
μπαινοβγαίνω -- I come / go in and out
μπορώ -- I can, am able, may
μυρίζω -- I smell
νομίζεται -- It is thought, considered
νομίζω -- I think, consider
ντύνομαι -- I dress [myself], get dressed
ντύνω -- I dress [something / someone]
ξέρω -- I know
ξαπλώνω -- I spread (out), lie down
ξεκινώ / ξεκινάω -- I start (out / off), set out / off
ξεχνώ / ξεχνάω -- I forget
ξυπνώ / ξυπνάω -- I wake up
ξυρίζομαι -- I shave [myself], get shaved
οδηγώ / οδηγάω -- I drive / steer [vehicle], guide, lead, instruct, show how (to)
ονομάζομαι -- I am named / called
πέφτω -- I fall (down / off), drop
πίνω -- I drink
παίζω -- I play, gamble
παίρνω -- I take, receive, get, hold
παθαίνω -- I suffer
παρακαλώ -- I request, beg, ask [favour]
πείθομαι -- I am persuaded
πείθω -- I persuade
πεθαίνω -- I die
πεινώ / πεινάω -- I am hungry, starving
πειράζει (δεν) -- It does(n`t) matter, bother, annoy, [never mind!]
περιμένω -- I wait (for), expect, await
περνώ / περνάω -- I pass (by / time), spend time, excel, overtake
περπατώ / περπατάω -- I walk
πετώ / πετάω -- I fly (off), throw (away), discard
πηγαίνω / πάω -- I go (for / on), take [convey]
πηδώ / πηδάω -- I jump (over), leap
πιάνομαι -- I am caught, seized
πιάνω -- I catch (hold of), seize, occupy, take (possession of)
πιστεύω -- I believe
πλένομαι / πλύνομαι -- I wash [myself], get washed
πλένω / πλύνω -- I wash [something / someone]
πλαγιάζω -- I lie down, put to bed, lay [something] down / on its side
πληρώνομαι -- I am paid (for)
πληρώνω -- I pay (for)
πλησιάζω -- I draw / bring / put near, approach
πονώ / πονάω -- I hurt, feel pain
ποτίζεται -- It is watered, dampened
ποτίζω -- I water, give drink (to)
πουλώ / πουλάω / πωλώ / πωλάω -- I sell
πρέπει -- It must, has to (be)
προσέχω -- I am careful (of), look after, notice, pay attention (to)
προσκαλώ -- I invite
προσπαθώ -- I try, attempt, make an effort
προσφέρω -- I offer, present
προτιμώ / προτιμάω -- I prefer
προφέρεται -- It is pronounced
ράβω -- I sew (on / up), stitch
ρίχνω -- I throw, cast, knock / pull down, drop
ρωτώ / ρωτάω -- I ask, question
σβήνω -- I extinguish, turn off [light, etc], put out, erase
σηκώνομαι -- I get up, rise
σκέφτομαι / σκέπτομαι -- I consider, think (about), reflect
σκοπεύω -- I aim (at), intend, take aim
σπάζω -- I break, smash
σπουδάζω -- I study
στέκομαι -- I stand (up / still)
στέλλω / στέλνω -- I send
σταματώ / σταματάω -- I stop
στρώνω -- I spread / lay (out) [something]
συγυρίζω -- I tidy up
συγχωρώ / συχωρώ -- I forgive, pardon, excuse
συλλέγω -- I collect, pick
συλλαμβάνομαι -- I am arrested, seized, caught
συλλαμβάνω -- I arrest, seize, catch
συμβαίνει -- It happens, occurs
συμβουλεύω -- I advise
συμφέρει -- It pays, is in / to one`s interest, is advantageous
συμφωνώ -- I agree
συναντώ / συναντάω -- I meet
συνεχίζεται -- It is continued
συνεχίζω -- I continue, go on
συστήνω / συνιστώ -- I recommend
σχίζω / σκίζω -- I tear, split
ταξιδεύω -- I travel, journey
ταχυδρομώ -- I post, mail
τελειώνω -- I finish, end, exhaust, use up
τηλεφωνώ / τηλεφωνάω -- I telephone
τρέφομαι -- I am fed, nourished, nurtured, cherished
τρέφω -- I feed, nourish, nurture, cherish
τρέχω -- I run, hasten, drive fast
τραβώ / τραβάω -- I pull, drag, attract, absorb, draw [weapon, money, etc]
τραγουδώ / τραγουδάω -- I sing
τρελαίνομαι / τρελλαίνομαι -- I go / am driven crazy / mad, am crazy (about / on)
τρώγεται -- It is eaten, edible
τρώγω / τρώω -- I eat, bite, consume
υπάρχω -- I exist, am
υπόσχομαι -- I promise
φέρνω / φέρω -- I bring, fetch, carry
φαίνομαι -- I appear, seem, am visible
φαντάζομαι -- I imagine, suppose
φεύγω -- I leave, depart, go away, escape
φοβάμαι / φοβούμαι -- I fear, am afraid (of)
φορώ / φοράω -- I wear, put on
φροντίζω -- I look after, take care (of)
φτάνω / φθάνω -- I arrive, draw near
φυσώ / φυσάω -- I blow (out), puff
φυτεύω -- I plant, implant
φωνάζω -- I shout, call (out), yell, summon
φωτογραφίζω -- I photograph
χάνω -- I lose, miss [opportunity]
χαιρετώ / χαιρετάω -- I greet
χαλώ / χαλάω -- I break (off / down), demolish, ruin, spoil, wear out
χαμογελώ / χαμογελάω -- I smile
χιονίζει -- It snows
χορεύω -- I dance (with)
χρειάζομαι -- I need, require, am necessary
χρησιμοποιώ -- I use
χτίζεται / κτίζεται -- It is built
χτίζω / κτίζω -- I build
χτενίζομαι / κτενίζομαι -- I comb [myself], get combed
χτενίζω / κτενίζω -- I comb [something / someone]
χτυπώ / χτυπάω / κτυπώ / κτυπάω -- I knock (at), strike, ring, clap, beat, hit, wound, hurt myself
χωρίζομαι -- I part (from), am separated, divorced
χωρίζω -- I separate, part, divide, divorce
ψαρεύω -- I fish (for)
ψωνίζω -- I do / go shopping
